abbath=abbathband
accept=accepttheband
after_forever=afterforever
agnostic_front=agnosticfront
alestorm=alestormband
all_shall_[erish=allshallperish
amaranthe=AmarantheBand
amon_amarth=OfficialAmonAmarth
amorphis=amorphis
arch_enemy=archenemyofficial
asagraum=asagraum
battlelore=BattleloreOfficial
belphegor=belphegor
bleed_the_sky=BleedTheSkyband
blind_guardian=blindguardian
byfrost=BYFROST
candlemass=candelmass
cathedral=cathedral
celeste=celesteband
children_of_bodom=childrenofbodom
chrome_division=chromedivision
clawfinger=clawfinger.net
communic=OfficialCommunic
cradle_of_filth=cradleoffilth
crematroy=Crematory
crimson_cult=CrimsonCult
cruachan=cruachanclan
dalriada=Dalriadahu
darkane=darkane
death=DeathOfficial
death_angel=deathangel
deathstars=deathstars
destruction=destruction
dethklok=OfficialDethklok
devin_townsend=dvntownsend
dew_scented=dewscented
die_apokalyptischen_reiter=Reitermania
dimmu_borgir=dimmuborgir
drudkh=Drudkh.Official
doro=DoroPeschOfficial
dragonforce=dragonforce
dream_theatre=dreamtheater
echoes_of_eternity=echoesofeternity
edguy=edguy
ektomorf=EktomorfOfficial
ensiferum=Ensiferum
enslaved=enslaved
epica=epica
equilibrium=equilibrium
eternal_tears_of_sorrow=etosofficial
evocation=EvocationSwe
exodus=exodusattack
farmer_boys=farmerboys.music
fejd=Fejdofficial
finntroll=officialfinntroll
freedom_call=FreedomCallOfficial
full_force=fullforceworld
gotthard=Gotthard
grave_digger=gravediggerofficial
graveworm=gravewormofficial
hammerfall=hammerfall
helloween=helloweenofficial
helheim=helheimnorway
hypocrisy=hypocrisy
in_flames=inflames
insomnium=insomniumofficial
kalmah=kalmahofficial
kataklysm=kataklysm
king_of_asgard=kingofasgard
kivimetsan_druidi=Kivimets%C3%A4n-Druidi-Official-162885747057446
knorkator=knorkatormusik
korpiklaani=korpiklaani
krisiun=krisiun.official
liquido=liquidomusic
malevolent_creation=malevolentcreation
moonsorrow=Moonsorrow-23474099648
meshuggah=meshuggah
mnemic=mnemic
nightwish=nightwish
nile=nilecatacombs
one_man_army_&_the_undead_quartet=Onemanarmyofficial-127506483942832
pungent_stench=pungentstench-official
pyogenesis=pyogenesis
rage=RageOfficialBand
rhapsody_of_fire=rhapsodyoffire
ride_the_sky=Ride-The-Sky-200740619966934
rotting_christ=Rotting-Christ-290468585669
sabaton=sabaton
samael=OfficialSamael
satyricon=SatyriconOfficial
scar_symmetry=scarsymmetry
sirenia=sirenia
soilwork=soilwork
sonata_arctica=sonataarctica
sonic_syndicate=SonicSyndicateBand
stratovarius=stratovarius
subway_to_sally=subwaytosally
such_a_surge=officialsuchasurge
svartsot=svartsot
sylvatica=SylvaticaOfficial
taake=taakeofficial
tankard=tankardofficial
tapping_the_vein=tappingthevein
tarot=tarot
the_kovenant=The-kovenant-101527333219534
therion=therion
threat_signal=threatsignal
threshold=threshold
thunderstone=ThunderstoneOfficial
tristania=tristania
turisas=turisas
tarot=tarot
the_69_eyes=the69eyes
thunderstone=ThunderstoneOfficial
tyr=tyrband
unsun=unsun
wintersun=wintersun
witchcraft=witchcraft
wolfheart=WolfheartRealm
xandria=xandriaofficial
